0  0  0  0  0  0  0  0  0  0  0  0  0  0  0  0  0  0  0  0  0  0  0  0  0  0  0  0  0  0  0  0  0  0  0  0  0  0  0  0   100
0  0  0  0  0  0  0  0  0  0  0  0  0  0  0  0  0  0  0  0  0  0  0  0  0  0  0  0  0  0  0  0  0  0  0  0  0  0  0  0 	 100
0  0  0  0  0  0  0  0  0  0  0  0  0  0  0  0  0  0  0  0  0  0  0  0  0  0  0  0  0  0  0  0  0  0  0  0  0  0  0  0	 100
0  3  3  3  3  0  0  0  0  0  0  0  0  0  0  0  0  0  0  0  0  0  0  0  0  0  0  0  0  0  0  0  0  0  0  0  0  0  0  0   100
0  3  4  4  3  0  0  0  0  0  0  0  0  0  0  0  0  0  0  0  0  0  0  0  0  0  0  0  0  0  0  0  0  0  0  0  0  0  0  0 	 100
0  3  4  4  3  0  0  0  0  0  0  0  0  0  0  0  0  0  0  0  0  0  0  0  0  0  0  0  0  0  0  0  0  0  0  0  0  0  0  0   100
0  3  7  4  4  0  0  0  0  0  0  0  0  0  0  0  0  0  0  0  0  0  0  0  0  0  0  0  0  0  0  0  0  0  0  0  0  0  0  0 	 100
0  3  3  3  3  3  0  0  0  0  0  0  0  0  0  0  0  0  0  0  0  0  0  0  0  0  0  0  0  0  0  0  0  0  0  0  0  0  0  0   100
0  0  3  3  0  3  3  0  0  0  0  0  0  0  0  0  0  0  0  0  0  0  0  0  0  0  0  0  0  0  0  0  0  0  0  0  0  0  0  0 	 100
0  0  3  3  0  3  3  3  0  0  0  0  0  0  0  0  0  0  0  0  0  0  0  0  0  0  0  0  0  0  0  0  0  0  0  0  0  0  0  0	 100
0  0  3  3  0  0  3  3  0  0  0  0  0  0  0  0  0  0  0  0  0  0  0  0  0  0  0  0  0  0  0  0  0  0  0  0  0  0  0  0   100
0  0  3  3  0  0  0  3  0  0  0  0  0  0  0  51 0  0  0  52 0  0  0  0  0  51 0  0  0  0  51 0  0  0  0  0  0  0  0  0 	 100
2  2  2  2  2  2  2  2  2  2  2  2  0  0  2  2  2  0  2  2  2  0  0  2  2  2  2  0  0  2  2  2  0  2  2  2  13 2  2  2   100
1  1  1  1  1  1  1  1  1  1  1  1  0  0  1  1  1  0  1  1  1  0  0  1  1  1  1  0  0  1  1  1  0  1  1  1  10 10 10 1   100
1  1  1  1  1  1  1  1  1  1  1  1  0  0  1  1  1  0  1  1  1  0  0  1  1  1  1  0  0  1  1  1  0  1  1  1  10 10 12 1   100
1  1  1  1  1  1  1  1  1  1  1  1  0  0  1  1  1  0  1  1  1  0  0  1  1  1  1  0  0  1  1  1  0  1  1  1  1  1  1  1   100
8000