0  0  0  0  0  0  0  0  0  0  0  0  0  0  0  0  0  0  0  0  0  0  0  0  0  0  0  0  0  0  0  0  0  0  0  0  0  0  0  0   100
0  0  0  0  0  0  0  0  0  0  0  0  0  0  0  0  0  0  0  0  0  0  0  0  0  0  0  0  0  0  0  0  0  0  0  0  0  0  0  0 	 100
0  0  0  0  0  0  0  0  0  0  0  0  0  0  0  0  0  0  0  0  0  0  0  0  0  0  0  0  0  0  0  0  0  0  0  0  0  0  0  0	 100
0  0  0  0  0  0  0  0  0  0  0  0  0  0  0  0  0  0  0  0  0  0  0  0  0  0  0  0  0  0  0  0  0  0  0  0  0  0  0  0   100
0  0  0  0  0  0  0  0  0  0  0  0  0  0  0  0  0  0  0  0  0  0  0  0  0  0  0  0  0  0  0  0  0  0  0  0  0  0  0  0   100
0  0  0  0  0  0  0  0  0  0  0  0  0  0  0  0  0  0  0  0  0  0  0  0  0  0  0  0  0  0  0  0  0  0  0  0  0  0  0  0 	 100
0  0  0  0  0  0  0  0  0  0  0  0  0  0  0  0  0  0  0  0  0  0  0  0  0  0  0  0  0  0  0  0  0  0  0  0  0  0  0  0	 100
0  0  0  0  0  0  0  0  0  0  0  0  0  0  0  0  0  0  0  0  0  0  0  0  0  0  0  0  0  0  0  0  0  0  0  0  0  0  0  0   100
0  0  0  0  0  0  0  0  0  0  0  0  0  0  0  0  0  0  0  0  0  0  0  0  0  0  0  0  0  0  0  0  0  0  0  0  0  0  0  0 	 100
0  0  0  0  0  0  0  0  0  0  0  0  0  0  0  0  0  0  0  0  0  0  0  0  0  0  0  0  0  0  0  0  0  0  0  0  0  0  0  0   100
0  0  0  0  0  0  0  0  0  0  0  0  0  0  0  0  0  0  0  0  0  0  0  0  0  0  0  0  0  0  0  0  0  0  0  0  0  0  0  0 	 100
0  0  0  0  0  0  0  0  0  0  0  0  0  0  0  0  0  0  0  0  0  0  0  0  0  0  0  0  0  0  0  0  0  0  0  0  0  0  0  0	 100
0  0  0  0  0  0  0  0  0  0  0  0  0  0  0  0  0  0  0  0  0  0  0  0  0  0  0  0  0  0  0  0  0  0  0  0  0  0  0  0   100
0  0  0  0  0  0  0  0  0  0  0  0  0  0  0  0  0  3  3  4  3  0  0  0  0  0  0  0  0  0  0  0  0  0  0  0  0  0  0  0 	 100
0  0  0  0  0  0  0  0  0  0  0  0  0  0  0  0  3  3  8  4  3  3  0  0  0  0  0  0  0  0  0  0  0  0  0  0  0  0  0  0   100
0  0  0  0  0  0  0  0  0  0  0  0  0  0  0  3  3  3  3  3  3  3  3  0  0  0  0  0  0  0  0  0  0  0  0  0  0  0  0  0 	 100
0  0  0  0  0  0  0  0  0  0  0  0  0  0  0  3  4  4  4  4  4  4  3  0  0  0  0  0  0  0  0  0  0  0  0  0  0  0  0  0	 100
0  0  0  0  0  0  0  0  0  0  0  0  0  0  0  3  4  4  4  4  4  4  3  3  0  0  0  0  0  0  0  0  0  0  0  0  0  0  0  0   100
0  0  0  0  0  0  0  0  0  0  0  0  0  0  0  3  4  4  4  4  4  60 4  0  0  3  0  0  0  0  0  0  0  0  0  0  0  0  0  0 	 100
0  0  0  0  0  0  0  0  0  0  0  0  0  0  0  3  4  4  4  3  3  3  3  3  3  3  0  0  0  0  0  0  0  0  0  0  0  0  0  0   100
0  0  0  0  0  0  0  0  0  0  0  0  0  0  0  3  4  4  3  4  4  4  3  3  0  0  0  0  0  0  0  0  0  0  0  0  0  0  0  0 	 100
0  0  0  0  0  0  0  0  0  0  0  0  0  0  0  3  4  4  4  4  4  4  3  0  0  0  0  0  0  0  0  0  0  0  0  0  0  0  0  0	 100
0  0  0  0  0  0  0  0  0  0  0  0  0  0  0  3  3  4  4  4  4  4  3  0  0  0  0  0  0  0  0  0  0  0  0  0  0  0  0  0   100
0  0  0  0  0  0  0  0  0  0  0  0  0  0  0  4  4  4  4  4  4  4  3  0  0  0  0  0  0  0  0  0  0  0  0  0  0  0  0  0 	 100
0  0  0  0  0  0  0  0  0  0  0  0  0  3  3  3  3  3  3  3  3  4  3  0  0  0  0  0  0  0  0  0  0  0  0  0  0  0  0  0   100
0  0  0  0  0  0  0  0  0  0  0  0  3  3  0  3  3  4  4  4  4  4  3  0  0  0  0  0  0  0  0  0  0  0  0  0  0  0  0  0 	 100
0  0  0  0  0  0  0  0  0  0  0  3  3  0  0  3  4  4  4  4  3  3  3  0  0  0  0  0  0  0  0  0  0  0  0  0  0  0  0  0	 100
0  0  0  0  0  0  0  0  0  0  3  3  0  0  0  3  4  4  4  3  3  3  3  0  0  0  0  0  0  0  0  0  0  0  0  0  0  0  0  0   100
0  0  5  0  0  0  0  0  0  3  3  0  0  0  0  3  4  4  4  4  4  4  4  0  0  0  0  0  0  0  0  0  0  0  0  0  0  0  0  0 	 100
2  2  2  2  2  2  2  2  2  2  2  2  2  2  2  2  2  2  2  2  2  2  2  2  2  2  2  2  2  2  2  2  2  2  2  2  2  2  2  2   100
1  1  1  1  1  1  1  1  1  1  1  1  1  1  1  1  1  1  1  1  1  1  1  1  1  1  1  1  1  1  1  1  1  1  1  1  1  1  1  1   100
1  1  1  1  1  1  1  1  1  1  1  1  1  1  1  1  1  1  1  1  1  1  1  1  1  1  1  1  1  1  1  1  1  1  1  1  1  1  1  1   100
1  1  1  1  1  1  1  1  1  1  1  1  1  1  1  1  1  1  1  1  1  1  1  1  1  1  1  1  1  1  1  1  1  1  1  1  1  1  1  1   100
8000