
0  0  0  0  0  0  0  0  0  0  0  0  0  0  0  0  0  0  0  0  0  0  0  0  0  0  0  0  0  0  0  0  0  0  0  0  0  0  0  0	100
0  0  0  0  0  0  0  0  0  0  0  0  0  0  0  0  0  0  0  0  0  0  0  0  0  0  0  0  0  0  0  0  0  0  0  0  0  0  0  0 	100
0  0  0  3  0  0  0  0  0  4  0  0  0  0  0  0  4  0  0  0  0  0  3  0  0  0  0  0  0  0  0  0  0  0  0  0  0  0  0  0	100
0  0  0  3  0  0  0  0  0  4  0  0  0  0  0  0  4  0  0  0  0  0  3  0  0  0  0  0  0  0  0  0  0  0  0  0  0  0  0  0 	100
0  0  3  3  4  4  4  4  4  3  3  0  0  0  0  3  3  4  4  4  4  4  3  3  0  0  0  0  0  0  0  0  0  0  0  0  0  0  0  0 	100
0  3  3  3  4  4  4  4  3  3  3  3  0  0  3  3  3  4  63 4  3  4  3  3  3  0  0  0  0  0  0  0  0  0  0  0  0  0  0  0 	100
0  3  3  3  4  4  4  63 4  3  3  3  0  0  3  3  3  3  3  3  3  4  3  3  3  0  0  0  0  0  0  0  0  0  0  0  0  0  0  0 	100
0  0  0  3  4  3  3  3  3  3  0  0  0  0  0  0  3  3  3  3  3  4  3  0  0  0  0  0  0  0  0  0  0  0  0  0  0  0  0  0	100
0  0  0  3  4  4  4  4  4  3  0  0  0  0  0  0  3  4  4  63 4  4  3  0  0  0  0  0  0  0  0  0  0  0  0  0  0  0  0  0 	100
0  0  0  3  3  3  3  3  4  3  0  0  0  0  0  0  3  4  3  3  3  3  3  0  0  0  0  0  0  0  0  0  0  0  0  0  0  0  0  0 	100
0  0  0  3  4  4  63 4  4  3  0  0  0  0  0  0  3  4  3  3  3  3  3  0  0  0  0  0  0  0  0  0  0  0  0  0  0  0  0  0 	100
3  3  3  3  4  3  3  3  3  3  0  0  0  0  0  0  3  4  3  3  3  3  3  0  0  0  0  0  0  0  0  0  0  0  0  0  0  0  0  0 	100
3  4  4  3  4  63 4  4  4  4  0  0  0  0  0  0  3  4  4  4  4  4  3  0  0  0  0  0  0  0  0  0  0  0  0  0  0  0  0  0	100
3  7  4  3  3  3  3  3  3  3  0  0  0  0  0  0  3  3  3  3  3  4  3  0  0  0  0  0  0  0  0  0  0  0  0  0  0  0  0  0 	100
3  3  4  4  4  4  4  4  4  4  0  0  0  0  0  0  3  4  4  4  4  4  4  0  0  0  0  0  53 0  0  0  0  0  0  0  0  0  0  0 	100
2  2  2  2  2  2  2  2  2  3  3  3  3  3  3  3  3  2  2  2  2  2  2  2  2  2  2  2  2  2  2  2  2  2  2  13 2  2  2  2	100
1  1  1  1  1  1  1  1  1  1  1  3  0  0  3  1  1  1  1  1  1  1  1  1  1  1  1  1  1  1  1  1  1  1  1  10 1  1  1  1	100
1  1  1  1  1  1  1  1  1  1  1  0  0  0  0  1  1  1  1  1  1  1  1  1  1  1  1  1  1  1  1  1  1  1  1  10 1  1  1  1	100
1  1  1  1  1  1  1  1  1  1  1  0  0  0  0  1  1  1  1  1  1  1  1  1  1  1  1  1  1  1  1  1  1  1  1  10 1  1  1  1	100
1  1  1  1  1  1  1  1  1  1  1  0  0  0  0  1  1  1  1  1  1  1  1  1  1  1  1  1  1  1  1  1  1  1  1  10 1  1  1  1	100
1  1  1  1  1  1  1  1  1  1  1  0  0  0  0  1  1  1  1  1  1  1  1  1  1  1  1  1  1  1  1  1  1  1  1  10 1  1  1  1	100
1  1  1  1  1  1  1  1  1  1  1  0  0  0  0  1  1  1  1  1  1  1  1  1  1  1  1  1  1  1  1  1  1  1  1  10 1  1  1  1	100
1  1  10 10 10 10 10 10 10 10 10 0  0  0  0  10 10 10 10 10 10 10 10 10 10 10 10 10 10 10 10 10 10 10 10 10 10 1  1  1	100
1  1  10 10 10 10 10 10 10 10 10 0  0  0  0  10 10 10 10 10 10 10 10 10 10 10 10 10 10 10 10 10 10 10 10 10 10 1  1  1	100
1  1  1  10 10 10 10 10 10 10 10 0  0  52 0  10 10 10 10 10 10 10 10 10 10 10 10 10 10 10 10 10 10 10 10 10 10 1  1  1	100
1  12 10 10 1  10 10 10 10 10 10 0  3  3  0  10 10 10 10 10 72 10 10 10 10 10 72 10 10 10 10 10 10 10 10 10 10 1  1  1  100
1  1  1  1  1  1  1  1  1  1  1  0  0  0  0  1  1  10 10 1  1  1  1  10 10 1  1  1  10 10 1  10 10 1  1  1  1  1  1  1	100
1  1  1  1  1  1  1  1  1  1  1  0  0  0  0  1  1  10 10 1  1  1  1  10 10 1  1  1  10 10 1  10 10 1  1  1  1  1  1  1  100

8000
