0  0  0  0  0  0  0  0  0  0  0  0  0  0  0  0  0  0  0  0  0  0  0  0  0  0  0  0  0  0  0  3  3  3  3  3  3  3  3  3 	100
0  0  0  0  0  0  0  0  0  0  0  0  0  0  0  0  0  0  0  0  0  0  0  0  0  0  0  0  0  0  0  3  4  4  4  3  4  4  4  3 	100
0  0  0  0  0  0  0  0  0  0  0  0  0  3  3  4  3  0  0  0  0  0  0  0  0  0  0  0  0  0  0  3  4  4  4  3  4  4  4  3 	100
0  0  0  0  0  0  0  0  0  0  0  0  0  3  4  4  3  0  0  0  0  0  0  0  0  0  0  0  0  0  0  4  4  4  4  3  4  4  4  3 	100
0  0  0  0  0  0  0  0  0  0  0  0  0  3  4  3  3  0  3  3  0  3  0  3  0  3  3  3  0  0  0  3  4  4  4  4  4  4  8  3	100
0  0  0  0  0  0  0  0  0  0  0  0  0  3  4  4  3  0  0  0  0  0  0  0  0  0  0  0  0  0  0  3  4  4  3  3  3  3  3  3	100
0  0  0  0  0  0  0  0  0  0  0  0  0  3  3  4  3  0  0  0  0  0  0  0  0  0  0  0  0  0  0  3  4  4  4  4  4  4  3  3 	100
0  0  0  0  0  0  0  0  0  0  0  0  0  3  4  4  3  0  0  0  0  0  0  0  0  0  0  0  0  0  0  3  3  4  4  4  4  4  4  3 	100
0  0  0  0  0  0  0  0  0  0  0  0  0  3  4  3  3  0  0  0  0  0  0  0  0  0  0  0  0  0  0  3  3  3  3  3  3  4  4  3 	100
0  0  0  0  0  0  0  0  0  0  0  0  0  3  4  4  3  0  0  0  0  0  0  0  0  0  0  0  0  0  0  3  4  4  4  4  4  3  4  3 	100
0  0  0  0  0  0  0  0  0  0  0  0  0  3  3  4  3  0  0  0  0  0  0  0  0  0  0  0  0  0  0  3  4  4  3  3  4  4  4  3 	100
0  5  0  0  0  0  0  0  0  0  0  0  0  4  4  4  4  0  0  0  0  0  0  0  0  0  0  0  0  0  0  4  4  3  3  3  4  4  3  3	100
2  2  2  2  2  2  0  0  2  2  2  2  2  2  2  2  2  2  2  2  2  0  0  0  0  0  0  0  0  2  2  2  2  2  2  2  2  2  2  2	100
1  1  1  1  1  1  0  0  1  1  1  1  1  1  1  1  1  1  1  1  1  0  0  0  0  0  0  0  0  1  1  1  1  1  1  1  1  1  1  1 	100
1  1  1  1  1  1  0  0  1  1  1  1  1  1  1  1  1  1  1  1  1  0  0  0  0  0  0  0  0  1  1  1  1  1  1  1  1  1  1  1 	100
1  1  1  1  1  1  0  0  1  1  1  1  1  1  1  1  1  1  1  1  1  0  0  0  0  0  0  0  0  1  1  1  1  1  1  1  1  1  1  1 	100

8000