1  1  1  1  1  1  1  1  1  1  1  0  0  0  0  1  1  1  1  1  1  1  1  1  1  1  1  1  1  1  1  1  1  1  1  10 1  1  1  1  1  100
1  1  1  1  1  1  1  1  1  1  1  0  0  0  0  1  1  1  1  1  1  1  1  1  1  1  1  1  1  1  1  1  1  1  1  10 10 10 10 1  1  100
1  1  1  1  1  1  1  1  1  1  1  0  0  0  0  1  1  1  1  1  1  1  1  1  1  1  1  1  1  1  1  1  1  1  1  10 10 10 11 1	1  100
1  1  1  1  1  1  1  1  1  1  1  0  0  0  0  1  1  1  1  1  1  1  1  1  1  1  10 10 10 10 10 10 10 10 1  10 1  1  1  1	1  100
1  1  1  1  1  1  1  1  1  1  1  0  0  0  0  1  1  1  1  1  1  1  1  1  1  1  10 1  1  1  1  1  1  10 1  10 1  1  1  1	1  100
1  1  1  1  1  1  1  1  1  1  1  0  0  0  0  1  1  1  1  1  1  1  1  1  1  1  10 1  1  1  1  1  10 10 73 10 10 73 10 10	1  100
1  1  1  1  1  1  1  1  1  1  1  0  0  0  0  1  1  1  1  1  1  1  1  1  1  1  10 1  1  1  1  1  10 1  1  1  1  1  1  10	1  100
1  1  1  1  1  1  1  1  1  1  1  0  0  0  0  1  1  1  1  1  1  1  1  1  1  1  10 1  1  1  1  1  10 1  1  1  1  1  1  10	1  100
1  1  1  1  1  1  1  1  1  1  1  0  0  0  0  1  1  1  1  1  1  1  1  1  1  1  10 1  1  1  1  1  10 1  1  1  1  1  1  10	1  100
1  1  1  1  1  1  1  1  1  1  1  0  0  0  0  1  1  1  1  1  1  1  1  1  1  1  10 1  1  1  1  1  10 1  1  1  1  1  1  10	1  100
1  1  1  1  1  1  1  1  1  1  1  0  0  0  0  1  1  1  1  1  1  1  1  1  1  1  10 1  1  1  1  1  10 1  1  1  1  1  1  10	1  100
1  10 10 10 10 10 10 10 10 10 10 0  0  0  0  10 10 10 10 10 10 10 10 10 10 10 10 10 10 10 10 10 10 10 10 10 10 10 10 10	1  100
1  10 10 10 10 10 10 10 10 10 10 0  0  0  0  10 10 10 10 10 10 10 10 10 10 10 10 10 10 10 10 10 10 10 10 10 10 10 10 10	1  100
1  12 10 10 10 10 10 10 10 10 10 0  3  3  0  10 10 10 10 10 10 10 10 10 10 10 10 10 10 10 10 10 10 10 10 10 10 10 10 10 1  100
1  1  1  1  1  1  1  1  1  1  1  0  0  0  0  1  1  10 10 1  1  1  1  10 1  1  1  1  10 10 10 10	10 10 10 10 10 10 10 10	1  100
1  1  1  1  1  1  1  1  1  1  1  0  0  0  0  1  1  10 10 1  1  1  1  10 1  1  1  1  10 10 10 10 10 10 10 10 10 10 10 10 1  100

8000